  
  ######################################     #############################
  #....................................#     #...........................#
  #....................................#     #...........................#
  #....................................#     #...........................#
  #....................................#     #...........................#
  #....................................#     #...........................#
  #....................................#     #...........................#
  #....................................#######...........................#
  #......................................................................#
  #......................................................................#
  #....................................#######...........................#
  #....................................#     #...........................#
  #....................................#     #...........................#
  #....................................#     #...........................#
  ############.......###################     ########......###############
             #.......#                              #......#
             #.......#                              #......#
  ############.......###################     ########......###############
  #....................................#     #...........................#
  #....................................#     #...........................#
  #....................................#     #...........................#
  #....................................#     #...........................#
  #....................................#     #...........................#
  #....................................#     #...........................#
  #....................................#######...........................#
  #......................................................................#
  #......................................................................#
  #....................................#######...........................#
  #....................................#     #...........................#
  #....................................#     #...........................#
  #....................................#     #...........................#
  ######################################     #############################
