 
 ############################################
 #..........#.....................#.........#
 #..........#.....................#.........#
 #..........#..........#..........#.........#
 #..........#..........#..........#.........#
 #..........#..........#..........#.........#
 #.....................#....................#
 #.....................#....................#
 ############################################
 
